...###
..##.#.####
.##..###..#
##........#
#...@.....#
###..###..#
..#..#....#
.##.##.#.##
.#......##
.#.....####
.#########